2,2,2,2,2,2,2,2,2,2,2,2,2,2,2,2,2,2,2,2,2,2,2,2,2
2,,,,,,,,,,,,,,,,,,,,,,,,2
2,,,1,,,,,,,,2,,,,2,,,,,,,,,2
2,,,1,,,,,,,,2,,,,2,,,,,,,,,2
2,,,1,,,,,,,,2,,,,2,2,2,2,2,2,2,2,2,2
2,,,1,,,,,,,,2,,,,2,9,9,9,9,9,9,9,9,2
2,,,1,,,,,,,,2,,,,2,9,9,9,9,9,9,9,9,2
2,,,1,,,,,,,,2,,,,2,9,9,9,9,9,9,9,9,2
2,,,1,,,,,,,,2,,,,2,9,9,9,9,9,9,9,9,2
2,,,1,,,,,,,,2,,,,2,9,9,9,9,9,9,9,9,2
2,,,1,,,,,,,,2,,,,2,9,9,9,9,9,9,9,9,2
2,,,1,,,,,,,,2,,,,2,2,2,2,2,2,2,,,2
2,,,1,,,,,,,,2,,,,,,,,,,,,,2
2,,,1,,,,,,,,2,,,,,,,,,,,,,2
2,,,1,,,,,,,,2,,,,,,,,,,,,,2
2,,,1,,,,,,,,2,,,,,,,,,,,,,2
2,,,,,,,,,,,,,,,,,,,,,,,,2
2,2,2,2,2,2,2,2,2,2,2,2,2,2,2,2,2,2,2,2,2,2,2,2,2
